10 10
l 3 0 4 1
w 9 4 1 1
@ 5 5 5 1
o 4 5 4 1
a 4 3 2 1
z 2 1 2 1
T 0 7 3 1
M 0 6 9 1
G 0 2 6 1
W 99 3 9 1
B 10 2 4 1
W 99 2 9 1
